###................#
##.................#
#.........X........#
#......######......#
###########........#
#..................#
#..................#
#..................#
#................###
#............#######
#1.........#########
####################
