############################################################
############################################################
############################################################
############################################################
############################################################
############################################################
############################################################
############################################################
########################.........###########################
#######################....#################################
######################.....WWWWW###.########################
######################..........W.....######################
#####################..................#####################
#####################1....#...A...#...X#####################
############################################################
############################################################
############################################################
############################################################