#..............#
#..............#
#..............#
#..............#
#..............#
#..............#
#..............#
#1............X#
################