###............#####
###........#########
###...............##
###..............###
###.............####
##...........#######
###.........########
###.......##########
###.....############
###.............####
###..........#..####
##..........###..###
###........####...##
###.......#####....#
###...#########....#
#############......#
############.......#
#########..........#
######.............#
###................#
###................#
###................#
###................#
##.................#
#.........X........#
#......######......#
###########........#
#..................#
#..................#
#..................#
#................###
#............#######
#1.........#########
####################
